sprites/map.png;16;10;48;
0000000000000000
1111000111000030
0001022101000010
2001020121000010
2201000101000010
2201000101000010
2201000101111110
2201101100000000
2220111000000000
2222000000000001
