000000000000000101000000000000
000000000000000101000000000000
000000000000000101000000000000
000000000000000101000000000000
000000000000000101000000000000
000000000000000101000000000000
000000000000000101000000000000
000000000000000101000000000000
000000000000000111000000000000
111111111111111111111111111111
000000000000010000010000000000
111111111111111111111111111111
000000000000000111000000000000
000000000000000101000000000000
000000000000000101000000000000
000000000000000101000000000000
000000000000000101000000000000
000000000000000101000000000000
000000000000000101000000000000
000000000000000101000000000000