000000000000000011111111111111
000000000000000000011111111111
000000011100000000000111111111
000001110000000000000001111111
000011100001111000000000011111
000000100000001110000000000000
000001100000000010000000000000
000111000000111110000000000000
001110000011100010000000000000
000011100000111000000000000000
000111000000000110000011000000
000001110000001100001110000000
000111000000000000111100000000
000011111000000001111000000000
000001111100000111111100000000
000000000001111111111110000000
000000011111111111100000000000
000001111111111111000000000000
000000000000000000000000000000
000000000000000000000000000000