111111111111111111111111111111
111111100001111000000000111111
110000000000000000111110000111
100000000001111001110111000011
100011110000011000000100000011
100111101110001100001100000111
110011101110000000000000001111
111000000111000110000001111111
111110000000001110010000111111
111111100000011100111110001111
111111000000000000000111100011
111111000111110000000001110111
111111100000111100000000011111
110011100000011100010000000111
110000000100000000111000001111
111111000000000000011100001111
111111111000000001100000011111
111110011011100000000000111111
111110000001111000000011111111
111111111111111111111111111111