1111111111111111111111111111
1111111000000000000000011111
1111000111110000001110001111
1110000000000000000011100011
1111111110000000110001110001
1100000000000011100000000001
1100001100011111000011100001
1100011001111000100110000101
1100011000000000111000000101
1100010000000000000000100001
1100001001111000000000110011
1110000000011111001100011111
1111111000000111111000000111
1111111111000000000000111111
1111111111111111111111111111
